20,20,20,20,20,20,20,20,20,20,20,20,20,20,20,20,20,20,20,20,20,20,20,20,20,20,20,20,20,20,20,20,20,20,20,20,20,20,20,20,20,20,20,20,20,20,20,20,20,20,20,20,20,20,20,20,20,20,20,20,20,20,20,20,20,20,20,20,20,20
20,20,20,20,20,20,20,20,20,20,20,20,20,20,20,20,20,20,20,20,20,20,20,20,20,20,20,20,20,20,20,20,20,20,20,20,20,20,20,20,20,20,20,20,20,20,20,20,20,20,20,20,20,20,20,20,20,20,20,20,20,20,20,20,20,20,20,20,20,20
20,20,20,20,20,20,20,20,20,20,20,20,20,20,20,20,20,20,20,20,20,20,20,20,20,20,20,20,20,20,20,20,20,20,20,20,20,20,20,20,20,20,20,20,20,20,20,20,20,20,20,20,20,20,20,20,20,20,20,20,20,20,20,20,20,20,20,20,20,20
20,20,20,20,20,20,20,20,20,20,20,20,20,20,20,20,20,20,20,20,20,20,20,20,20,20,20,20,20,20,20,20,20,20,20,20,20,20,20,20,20,20,20,20,20,20,20,20,20,20,20,20,20,20,20,20,20,20,20,20,20,20,20,20,20,20,20,20,20,20
20,20,20,20,20,20,20,20,20,20,20,20,20,20,20,20,20,20,20,20,20,20,20,20,20,20,20,20,20,20,20,20,20,20,20,20,20,20,20,20,20,20,20,20,20,20,20,20,20,20,20,20,20,20,20,20,20,20,20,20,20,20,20,20,20,20,20,20,20,20
20,20,20,20,20,20,20,20,20,20,20,20,20,20,20,20,20,20,20,20,20,20,20,20,20,20,20,20,20,20,20,20,20,20,20,20,20,20,20,20,20,20,20,20,20,20,20,20,20,20,20,20,20,20,20,20,20,20,20,20,20,20,20,20,20,20,20,20,20,20
20,20,20,20,20,20,20,20,20,20,20,20,20,20,20,20,20,20,20,20,20,20,20,20,20,20,20,20,20,20,20,20,20,20,20,20,20,20,20,20,20,20,20,20,20,20,20,20,20,20,20,20,20,20,20,20,20,20,20,20,20,20,20,20,20,20,20,20,20,20
20,20,20,20,20,20,20,20,20,20,20,20,20,20,20,20,20,20,20,20,20,20,20,20,20,20,20,20,20,20,20,20,20,20,20,20,20,20,20,20,20,20,20,20,20,20,20,20,20,20,20,20,20,20,20,20,20,20,20,20,20,20,20,20,20,20,20,20,20,20
20,20,20,20,20,20,20,20,20,20,20,20,20,20,20,20,20,20,20,20,20,20,20,20,20,20,20,20,20,20,20,20,20,20,20,20,20,20,20,20,20,20,20,20,20,20,20,20,20,20,20,20,20,20,20,20,20,20,20,20,20,20,20,20,20,20,20,20,20,20
20,20,20,20,20,20,20,20,20,20,20,20,20,20,20,20,20,20,20,20,20,20,20,20,20,20,20,20,20,20,20,20,20,20,20,20,20,20,20,20,20,20,20,20,20,20,20,20,20,20,20,20,20,20,20,20,20,20,20,20,20,20,20,20,20,20,20,20,20,20
20,20,20,20,20,20,20,20,20,20,20,20,20,20,20,20,20,20,20,20,13,42,42,42,42,42,42,42,42,42,42,42,42,3,20,20,20,20,20,20,20,20,20,20,13,42,42,42,42,42,42,42,42,42,42,3,20,20,20,20,20,20,20,20,20,20,20,20,20,20
20,20,20,20,20,20,20,20,20,20,20,20,20,20,20,20,20,20,20,20,12,38,0,0,0,0,0,31,0,0,0,0,0,1,20,20,20,20,20,20,20,20,20,20,2,0,0,0,0,0,0,0,0,0,0,49,3,20,20,20,20,20,20,20,20,20,20,20,20,20
20,20,20,20,20,20,20,20,20,20,20,20,13,42,42,42,42,42,42,42,42,47,0,0,0,0,0,0,0,0,0,0,0,1,20,20,20,20,20,20,20,20,20,20,2,0,0,0,0,0,0,0,0,0,0,0,49,3,20,20,20,20,20,20,20,20,20,20,20,20
20,20,20,20,20,20,20,20,20,20,13,42,47,0,0,0,0,0,0,0,0,0,0,0,0,0,0,0,0,0,0,31,0,1,20,20,20,20,20,20,20,20,20,20,2,0,0,0,0,0,0,0,0,0,0,0,0,49,3,20,20,20,20,20,20,20,20,20,20,20
20,20,20,20,20,20,20,20,20,20,2,0,0,0,0,0,0,0,0,0,0,0,0,0,0,0,0,0,0,0,0,0,0,1,20,20,20,20,20,20,20,20,20,20,2,0,0,0,0,0,0,0,0,0,0,0,0,0,1,20,20,20,20,20,20,20,20,20,20,20
20,20,20,20,20,20,20,20,20,20,2,0,0,0,0,0,0,0,0,0,0,0,0,0,0,0,0,0,0,0,0,0,0,1,20,20,20,20,20,20,20,20,20,20,2,0,0,0,0,0,0,0,0,0,0,0,0,0,1,20,20,20,20,20,20,20,20,20,20,20
20,20,20,20,20,20,20,20,20,20,2,0,0,0,0,0,0,0,0,0,0,0,0,0,0,0,0,0,0,0,0,0,0,1,20,20,20,20,20,20,20,20,20,20,2,0,0,0,0,0,0,0,0,0,0,0,0,0,1,20,20,20,20,20,20,20,20,20,20,20
20,20,20,20,20,20,20,20,20,20,2,0,0,0,0,0,0,0,0,0,0,0,0,0,0,0,0,0,0,0,0,0,0,1,22,20,20,20,20,20,20,20,20,20,2,0,0,0,0,0,0,0,0,0,0,0,0,0,1,20,20,20,20,20,20,20,20,20,20,20
20,20,20,20,20,20,20,20,20,20,2,0,0,0,0,0,0,0,0,0,0,0,0,0,0,0,0,0,0,0,0,0,-1,1,22,20,20,20,20,20,20,20,20,20,2,0,0,0,0,0,0,0,0,0,0,0,0,0,1,20,20,20,20,20,20,20,20,20,20,20
20,20,20,20,20,20,20,20,20,20,2,0,0,0,0,0,0,0,0,0,0,0,0,0,0,0,0,0,0,0,0,0,-1,1,20,20,20,20,20,20,20,20,20,20,2,0,0,0,0,0,0,0,0,0,0,0,0,0,1,20,20,20,20,20,20,20,20,20,20,20
20,20,20,20,20,20,20,20,20,20,2,0,0,0,0,0,0,0,0,0,0,0,0,0,0,0,0,0,0,0,0,0,-1,1,20,20,20,20,20,20,20,20,20,20,2,0,0,0,0,0,0,0,0,0,0,0,0,0,49,3,20,20,20,20,20,20,20,20,20,20
20,20,20,20,20,20,20,20,20,20,2,0,0,0,0,0,0,0,0,0,0,0,0,0,0,0,0,0,0,0,0,0,0,49,42,42,42,42,42,42,42,42,42,42,47,0,0,0,0,0,0,0,0,0,0,0,0,0,0,1,20,20,20,20,20,20,20,20,20,20
20,20,20,20,20,20,20,20,20,20,2,0,0,0,0,0,0,0,0,0,0,0,0,0,0,0,0,0,0,0,0,0,0,0,0,0,0,0,0,0,0,0,0,0,0,0,0,0,0,0,0,0,0,0,0,0,0,0,0,1,20,20,20,20,20,20,20,20,20,20
20,20,20,20,20,20,20,20,20,20,2,0,0,0,0,0,0,0,0,0,0,0,0,0,0,0,0,0,0,0,0,0,0,0,0,0,0,0,0,0,0,0,0,0,0,0,0,0,0,0,0,0,0,0,0,0,0,0,0,1,20,20,20,20,20,20,20,20,20,20
20,20,20,20,20,20,20,20,20,20,2,0,0,0,0,0,0,0,0,0,0,0,0,0,0,0,0,0,0,0,0,0,0,0,0,0,0,0,0,0,0,0,0,0,0,0,0,0,0,0,0,0,0,0,0,0,0,0,0,1,20,20,20,20,20,20,20,20,20,20
20,20,20,20,20,20,20,20,20,20,12,38,0,0,0,0,0,0,0,0,0,0,0,0,0,0,0,0,0,0,0,0,0,0,0,0,0,0,0,0,0,0,0,0,0,0,0,0,0,0,0,0,0,0,0,0,48,10,38,1,20,20,20,20,20,20,20,20,20,20
20,20,20,20,20,20,20,20,20,20,20,2,0,0,0,0,0,0,0,0,0,0,0,0,0,0,0,0,0,0,0,0,0,0,0,0,0,0,0,0,0,0,0,0,0,0,0,0,0,0,0,0,0,0,0,0,1,20,2,1,20,20,20,20,20,20,20,20,20,20
20,20,20,20,20,20,20,20,20,20,20,12,38,0,0,0,0,0,0,0,0,0,0,0,0,0,0,0,0,0,0,0,0,0,0,0,0,0,0,0,0,0,0,0,0,0,0,0,0,0,0,0,0,0,0,0,1,20,2,1,20,20,20,20,20,20,20,20,20,20
20,20,20,20,20,20,20,20,20,20,20,20,12,10,10,10,10,10,10,10,11,11,11,11,11,11,41,0,0,0,52,10,10,10,10,10,10,10,10,10,10,10,38,0,0,0,0,0,0,0,0,0,0,0,0,0,1,20,2,1,20,20,20,20,20,20,20,20,20,20
20,20,20,20,20,20,20,20,20,20,20,20,20,20,20,20,20,20,20,20,22,22,22,22,22,22,2,0,0,0,1,20,20,20,20,20,20,20,20,20,20,20,2,0,0,0,0,0,0,0,0,0,0,0,0,0,1,20,2,1,20,20,20,20,20,20,20,20,20,20
20,20,20,20,20,20,20,20,20,20,20,20,20,20,20,20,20,20,20,20,22,22,22,22,22,22,2,0,0,0,1,20,20,20,20,20,20,20,20,20,20,20,2,0,0,0,0,0,0,0,0,0,0,0,0,0,1,20,2,1,20,20,20,20,20,20,20,20,20,20
20,20,20,20,20,20,20,20,20,20,20,20,20,20,20,20,20,20,20,20,22,22,22,22,22,22,2,0,0,0,1,20,20,20,20,20,20,20,20,20,20,20,2,0,0,0,0,0,0,0,0,0,0,0,0,0,1,20,2,1,20,20,20,20,20,20,20,20,20,20
20,20,20,20,20,20,20,20,20,20,20,13,42,42,42,42,42,42,42,42,46,46,46,46,46,46,51,0,0,0,53,42,42,42,42,42,42,42,3,20,20,20,2,0,0,0,0,0,0,0,0,0,0,0,0,0,1,20,2,1,20,20,20,20,20,20,20,20,20,20
20,20,20,20,20,20,20,20,20,20,20,2,0,0,0,0,0,0,0,0,0,0,0,0,0,0,0,0,0,0,0,0,0,0,0,0,0,0,1,20,20,20,2,0,0,0,0,0,0,0,0,0,0,0,0,0,1,20,2,1,20,20,20,20,20,20,20,20,20,20
20,20,20,20,20,20,20,20,20,20,13,47,0,0,0,0,0,0,0,0,0,0,0,0,0,0,0,0,0,0,0,0,0,0,0,0,0,0,49,42,42,42,47,0,0,0,0,0,0,0,0,0,0,0,0,0,1,20,2,1,20,20,20,20,20,20,20,20,20,20
20,20,20,20,20,20,20,20,20,20,2,0,0,0,0,0,0,0,0,0,0,0,0,0,0,0,0,0,0,0,0,0,0,0,0,0,0,0,0,0,0,0,0,0,0,0,0,0,0,0,0,0,0,0,0,0,49,42,47,1,20,20,20,20,20,20,20,20,20,20
20,20,20,20,20,20,20,20,20,20,2,0,0,0,0,0,0,0,0,0,0,0,0,0,0,0,0,0,0,0,0,0,0,0,0,0,0,0,48,10,10,10,38,0,0,0,0,0,0,0,0,0,0,0,0,0,0,0,0,1,20,20,20,20,20,20,20,20,20,20
20,20,20,20,20,20,20,20,20,20,2,0,0,0,0,0,0,0,0,0,0,0,0,0,0,0,0,0,0,0,0,0,0,0,0,48,10,10,11,20,20,20,12,10,10,10,10,10,10,10,10,10,10,10,10,10,10,10,10,11,20,20,20,20,20,20,20,20,20,20
20,20,20,20,20,20,20,20,20,20,2,0,0,0,0,0,0,0,0,0,0,0,0,0,0,0,0,0,0,0,0,0,0,0,0,1,20,20,20,20,20,20,20,20,20,20,20,20,20,20,20,20,20,20,20,20,20,20,20,20,20,20,20,20,20,20,20,20,20,20
20,20,20,20,20,20,20,20,20,20,2,0,0,0,0,0,0,0,0,0,0,0,0,0,0,0,0,0,0,0,0,0,0,0,0,1,20,20,20,20,20,20,20,20,20,20,20,20,20,20,20,20,20,20,20,20,20,20,20,20,20,20,20,20,20,20,20,20,20,20
20,20,20,20,20,20,20,20,20,20,2,0,0,0,0,0,0,0,0,0,0,0,0,0,0,0,0,0,0,0,0,0,0,0,0,1,20,20,20,20,20,20,20,20,20,20,20,20,20,20,20,20,20,20,20,20,20,20,20,20,20,20,20,20,20,20,20,20,20,20
20,20,20,20,20,20,20,20,20,20,2,0,0,0,0,0,0,0,0,0,0,0,0,0,0,0,0,0,0,0,0,0,0,0,0,1,20,20,20,20,20,20,20,20,20,20,20,20,20,20,20,20,20,20,20,20,20,20,20,20,20,20,20,20,20,20,20,20,20,20
20,20,20,20,20,20,20,20,20,20,2,0,0,0,0,0,0,0,0,0,0,0,0,0,0,0,0,0,0,0,0,0,0,0,0,1,20,20,20,20,20,20,20,20,20,20,20,20,20,20,20,20,20,20,20,20,20,20,20,20,20,20,20,20,20,20,20,20,20,20
20,20,20,20,20,20,20,20,20,20,2,0,0,0,0,0,0,0,0,0,0,0,0,0,0,0,0,0,0,0,0,0,0,0,0,49,42,42,42,42,42,42,42,42,42,42,42,42,42,42,42,42,42,42,42,42,42,42,42,3,20,20,20,20,20,20,20,20,20,20
20,20,20,20,20,20,20,20,20,20,2,0,0,0,0,0,0,0,0,0,0,0,0,0,0,0,0,0,0,0,0,0,0,0,0,0,0,0,0,0,0,0,0,0,0,0,0,0,0,0,0,0,0,0,0,0,0,0,0,1,20,20,20,20,20,20,20,20,20,20
20,20,20,20,20,20,20,20,20,20,2,0,0,0,0,0,0,0,0,0,0,0,0,0,0,0,0,0,0,0,0,0,0,0,0,48,10,10,10,10,10,10,38,0,0,0,0,0,0,0,0,0,0,0,0,0,0,0,0,1,20,20,20,20,20,20,20,20,20,20
20,20,20,20,20,20,20,20,20,20,2,0,0,0,0,0,0,0,0,0,0,0,0,0,0,0,0,0,0,0,0,0,0,0,0,1,20,20,20,20,20,20,2,0,0,0,0,0,0,0,0,0,0,0,0,0,0,0,0,1,20,20,20,20,20,20,20,20,20,20
20,20,20,20,20,20,20,20,20,20,2,0,0,0,0,0,0,0,0,0,0,0,0,0,0,0,0,0,0,0,0,0,0,0,0,1,20,20,20,20,20,20,2,0,0,0,0,0,0,0,0,0,0,0,0,0,0,0,0,1,20,20,20,20,20,20,20,20,20,20
20,20,20,20,20,20,20,20,20,20,2,0,0,0,0,0,0,0,0,0,0,0,0,0,0,0,0,0,0,0,0,0,0,0,0,1,20,20,20,20,20,20,2,0,0,0,0,0,0,0,0,0,0,0,0,0,0,0,0,1,20,20,20,20,20,20,20,20,20,20
20,20,20,20,20,20,20,20,20,20,2,0,0,0,0,0,0,0,0,0,0,0,0,0,0,0,0,0,0,0,0,0,0,0,0,1,20,20,20,20,20,20,2,0,0,0,0,0,0,0,0,0,0,0,0,0,0,0,0,1,20,20,20,20,20,20,20,20,20,20
20,20,20,20,20,20,20,20,20,20,2,0,0,0,0,0,0,0,0,0,0,0,0,0,0,0,0,0,0,0,0,0,0,0,0,1,20,20,20,20,20,20,2,0,0,0,0,0,0,0,0,0,0,0,0,0,0,0,0,1,20,20,20,20,20,20,20,20,20,20
20,20,20,20,20,20,20,20,20,20,2,0,0,0,0,0,0,0,0,0,0,0,0,0,0,0,0,0,0,0,0,0,0,0,0,1,20,20,20,20,20,20,2,0,0,0,0,0,0,0,0,0,0,0,0,0,0,0,0,1,20,20,20,20,20,20,20,20,20,20
20,20,20,20,20,20,20,20,20,20,12,38,0,0,0,0,0,0,0,0,0,0,0,0,0,0,0,0,0,0,0,0,0,0,0,1,20,20,20,20,20,20,2,0,0,0,0,0,0,0,0,0,0,0,0,0,0,0,0,1,20,20,20,20,20,20,20,20,20,20
20,20,20,20,20,20,20,20,20,20,20,2,0,0,0,48,10,38,0,0,0,0,0,0,0,0,0,0,0,0,0,0,0,0,0,1,20,20,20,20,20,20,2,0,0,0,0,0,0,0,0,0,0,0,0,0,0,0,0,1,20,20,20,20,20,20,20,20,20,20
20,20,20,20,20,20,20,20,20,20,20,2,0,0,48,11,20,2,0,0,0,0,0,0,0,0,0,0,0,0,0,0,0,0,0,1,20,20,20,20,20,20,2,0,0,0,0,0,0,0,0,0,0,0,0,0,0,0,0,1,20,20,20,20,20,20,20,20,20,20
20,20,20,20,20,20,20,20,20,20,20,12,38,0,1,20,20,12,38,0,0,0,0,0,0,0,0,0,0,0,0,0,0,0,0,1,20,20,20,20,20,20,2,0,0,0,0,0,0,0,0,0,0,0,0,0,0,0,0,1,20,20,20,20,20,20,20,20,20,20
20,20,20,20,20,20,20,20,20,20,20,20,12,38,1,20,20,20,2,0,0,0,0,0,0,0,0,0,0,0,0,0,0,0,0,1,20,20,20,20,20,20,2,0,0,0,0,0,0,0,0,0,0,0,0,0,0,0,0,1,20,20,20,20,20,20,20,20,20,20
20,20,20,20,20,20,20,20,20,20,20,20,20,12,11,20,20,20,12,38,0,0,0,0,0,0,0,48,10,38,0,0,0,0,0,1,20,20,20,20,20,20,2,0,0,0,0,0,0,0,0,0,0,0,0,0,0,0,0,1,20,20,20,20,20,20,20,20,20,20
20,20,20,20,20,20,20,20,20,20,20,20,20,20,20,20,20,20,20,2,0,0,0,0,0,0,0,1,20,2,0,0,0,0,0,1,20,20,20,20,20,20,2,0,0,0,0,0,0,0,0,0,0,0,0,0,0,0,0,1,20,20,20,20,20,20,20,20,20,20
20,20,20,20,20,20,20,20,20,20,20,20,20,20,20,20,20,20,20,12,10,10,10,10,10,10,10,11,20,12,10,10,10,10,10,11,20,20,20,20,20,20,12,10,10,10,10,10,10,10,10,10,10,10,10,10,10,10,10,11,20,20,20,20,20,20,20,20,20,20
20,20,20,20,20,20,20,20,20,20,20,20,20,20,20,20,20,20,20,20,20,20,20,20,20,20,20,20,20,20,20,20,20,20,20,20,20,20,20,20,20,20,20,20,20,20,20,20,20,20,20,20,20,20,20,20,20,20,20,20,20,20,20,20,20,20,20,20,20,20
20,20,20,20,20,20,20,20,20,20,20,20,20,20,20,20,20,20,20,20,20,20,20,20,20,20,20,20,20,20,20,20,20,20,20,20,20,20,20,20,20,20,20,20,20,20,20,20,20,20,20,20,20,20,20,20,20,20,20,20,20,20,20,20,20,20,20,20,20,20
20,20,20,20,20,20,20,20,20,20,20,20,20,20,20,20,20,20,20,20,20,20,20,20,20,20,20,20,20,20,20,20,20,20,20,20,20,20,20,20,20,20,20,20,20,20,20,20,20,20,20,20,20,20,20,20,20,20,20,20,20,20,20,20,20,20,20,20,20,20
20,20,20,20,20,20,20,20,20,20,20,20,20,20,20,20,20,20,20,20,20,20,20,20,20,20,20,20,20,20,20,20,20,20,20,20,20,20,20,20,20,20,20,20,20,20,20,20,20,20,20,20,20,20,20,20,20,20,20,20,20,20,20,20,20,20,20,20,20,20
20,20,20,20,20,20,20,20,20,20,20,20,20,20,20,20,20,20,20,20,20,20,20,20,20,20,20,20,20,20,20,20,20,20,20,20,20,20,20,20,20,20,20,20,20,20,20,20,20,20,20,20,20,20,20,20,20,20,20,20,20,20,20,20,20,20,20,20,20,20
20,20,20,20,20,20,20,20,20,20,20,20,20,20,20,20,20,20,20,20,20,20,20,20,20,20,20,20,20,20,20,20,20,20,20,20,20,20,20,20,20,20,20,20,20,20,20,20,20,20,20,20,20,20,20,20,20,20,20,20,20,20,20,20,20,20,20,20,20,20
20,20,20,20,20,20,20,20,20,20,20,20,20,20,20,20,20,20,20,20,20,20,20,20,20,20,20,20,20,20,20,20,20,20,20,20,20,20,20,20,20,20,20,20,20,20,20,20,20,20,20,20,20,20,20,20,20,20,20,20,20,20,20,20,20,20,20,20,20,20
20,20,20,20,20,20,20,20,20,20,20,20,20,20,20,20,20,20,20,20,20,20,20,20,20,20,20,20,20,20,20,20,20,20,20,20,20,20,20,20,20,20,20,20,20,20,20,20,20,20,20,20,20,20,20,20,20,20,20,20,20,20,20,20,20,20,20,20,20,20
20,20,20,20,20,20,20,20,20,20,20,20,20,20,20,20,20,20,20,20,20,20,20,20,20,20,20,20,20,20,20,20,20,20,20,20,20,20,20,20,20,20,20,20,20,20,20,20,20,20,20,20,20,20,20,20,20,20,20,20,20,20,20,20,20,20,20,20,20,20
20,20,20,20,20,20,20,20,20,20,20,20,20,20,20,20,20,20,20,20,20,20,20,20,20,20,20,20,20,20,20,20,20,20,20,20,20,20,20,20,20,20,20,20,20,20,20,20,20,20,20,20,20,20,20,20,20,20,20,20,20,20,20,20,20,20,20,20,20,20
